RaceLevel1
{
{1,1,1,1,1,1,1, 1,1,1,1,1,1,1, 1,1,1,1,1,1,1},
{1,0,0,0,0,0,0, 0,1,0,0,0,0,1, 1,0,0,0,0,0,1},
{1,0,0,0,0,1,1, 0,1,0,0,0,0,1, 1,0,0,0,0,3,1},
{1,0,0,0,1,1,1, 0,1,0,0,1,0,1, 1,1,0,0,1,1,1},
{1,2,0,0,1,0,0, 0,0,0,0,1,0,0, 0,0,0,1,0,0,1},
{1,1,1,0,0,0,1, 0,0,1,0,0,0,0, 0,0,1,1,1,1,1},
{1,1,1,1,1,1,1, 1,1,1,1,1,1,1, 1,1,1,1,1,1,1},
};

RaceLevel2
{
{1,1,1,1,1,1,1, 1,1,1,1,1,1,1, 1,1,1,1,1,1,1},
{1,0,0,0,0,0,1, 0,0,0,0,0,0,0, 0,0,0,0,0,3,1},
{1,0,1,1,0,0,1, 0,1,1,0,0,1,1, 0,0,1,1,1,1,1},
{1,0,0,0,0,0,0, 0,0,0,0,0,0,0, 0,0,0,0,0,0,1},
{1,1,0,0,1,1,0, 0,1,0,0,1,0,0, 1,0,0,1,1,0,1},
{1,2,0,0,0,0,0, 0,0,0,0,0,0,0, 0,0,0,0,0,0,1},
{1,1,1,1,1,1,1, 1,1,1,1,1,1,1, 1,1,1,1,1,1,1},
};
RaceLevel3
{
{1,1,1,1,1,1,1, 1,1,1,1,1,1,1},
{1,0,0,0,0,0,0, 0,0,0,0,0,0,1},
{1,0,2,0,0,0,0, 0,0,0,0,0,0,1},
{1,1,1,1,1,0,0, 0,0,0,0,0,0,1},
{1,1,1,1,1,0,0, 0,0,0,0,0,0,1},
{1,1,1,1,1,1,1, 1,0,0,0,1,1,1},
{1,0,0,0,0,0,0, 0,0,0,0,0,1,1},

{1,0,0,0,0,0,0, 0,0,0,0,0,0,1},
{1,1,1,0,0,0,0, 1,1,1,1,1,1,1},
{1,0,0,0,0,0,0, 1,0,0,0,0,0,1},
{1,0,0,1,1,1,1, 1,0,0,1,0,0,1},
{1,0,0,0,0,0,0, 0,0,1,1,0,3,1},
{1,0,0,0,0,0,0, 0,1,1,1,0,1,1},
{1,1,1,1,1,1,1, 1,1,1,1,1,1,1},
};
RaceLevel4
{
{1,1,1,1,1,1,1, 1,1,1,1,1,1,1, 1,1,1,1,1,1,1},
{1,0,0,0,0,0,0, 0,1,0,0,0,1,1, 1,1,1,1,1,1,1},
{1,0,1,1,1,1,1, 0,0,0,1,0,0,0, 0,0,0,0,0,0,1},
{1,0,0,0,0,0,1, 1,1,1,1,1,1,1, 1,1,1,1,0,0,1},
{1,1,1,1,1,0,1, 0,0,0,0,0,0,0, 0,0,1,1,0,0,1},
{1,2,0,0,0,0,1, 0,3,0,0,1,0,0, 1,0,0,0,0,0,1},
{1,1,1,1,1,1,1, 1,1,1,1,1,1,1, 1,1,1,1,1,1,1},
};
RaceLevel5
{
{1,1,1,1,1,1,1, 1,1,1,1,1,1,1},
{1,0,0,0,0,0,0, 0,0,0,0,0,0,1},
{1,0,1,1,1,1,1, 0,0,0,0,3,0,1},
{1,0,0,1,0,0,0, 0,0,0,1,1,1,1},
{1,1,0,1,0,0,1, 1,1,1,1,1,1,1},
{1,0,0,1,0,0,0, 0,0,0,0,1,1,1},
{1,0,1,1,1,0,0, 0,0,0,1,1,1,1},

{1,0,0,1,0,0,1, 1,1,1,1,1,1,1},
{1,1,0,1,0,1,1, 1,1,1,1,1,1,1},
{1,0,0,1,0,0,0, 0,0,0,0,0,0,1},
{1,0,1,1,1,1,1, 1,0,0,0,0,0,1},
{1,0,0,0,0,0,0, 0,0,0,0,0,0,1},
{1,1,2,0,0,0,0, 0,1,1,1,1,1,1},
{1,1,1,1,1,1,1, 1,1,1,1,1,1,1},
};